wwwwwwwwwwwwwwwwwwwwwwwwwwwwwwww
ww w w w w w w w w w w w w w w w
ww w w w w w w w w w w w w w w w
w                              w
w                              w
w                              w
w     +        +       +       w
w                              w
w       + + + + + + + + +   ee w
w s    + + + + + + + + + +  ee w
w                              w
w     +        +       +       w
w                              w
w                              w
w                              w
w w w w w w w w w w w w w w w ww
w w w w w w w w w w w w w w w ww
wwwwwwwwwwwwwwwwwwwwwwwwwwwwwwww
