wwwwwwwwwwwwwwwwwwwwwwwwwwwwwwww
w                              w
w                              w
w                              w
w                              w
w                +             w
w                              w
w                              w
w                           ee w
w s                         ee w
w                              w
w                              w
w                              w
w                              w
w                              w
w                   n          w
w                              w
wwwwwwwwwwwwwwwwwwwwwwwwwwwwwwww
